1111111111111
10010000000C1
10I0011111101
1P001100000E1
1111111111111