11111111
1P0CCC11
111C1EC1
1CCC1CC1
1CCC1CC1
11111111