11111111
1P0CC111
111C1EC1
1CCC1CC1
1CCC1CC1
11111111