11111111
1CCCCC11
1CCCCEC1
1CCCCPC1
1CCCCCC1
11111111