11111111
1CCCCCC1
1CCCCEC1
1CCCCPC1
1CCCCCC1
11111111